organism	Severe acute respiratory syndrome coronavirus 2
isolate	isolate XXXXX
isolation_source	pharyngeal swab
host	Homo sapiens
source_country	Japan: Shizuoka
collection_date	2021-03-20
projectType	vrl
submitter	Fujisawa,T.; Mori,H.; Tanizawa,Y.; Nakamura,Y.; Arita,M.
consrtm	Shizuoka Pref. Consortium for Covid19
contact	Masanori Arita
email	mss@ddbj.nig.ac.jp
phone	81-000-000-000
institute	DNA Data Bank of Japan
department	National Institute of Genetics
url	https://ddbj.nig.ac.jp
street	1111 Yata
city	Mishima
state	Shizuoka
country	Japan
ZIP	411-8540
assemblyMethod	META_VRY v0.0.1
sequencingTechnology	Illumina MiSeq
coverage	2000x
reference	Complete genome sequence of Severe acute respiratory syndrome coronavirus 2 isolate XXXXXX
author	Fujisawa,T.; Mori,H.; Tanizawa,Y.; Nakamura,Y.; Arita,M.
year	2021
comment	Sequenced and annotated at NIG
source_note	Sample is provided from Shizuoka Pref.
